2222222222222222222222222222
2000000000000220000000000002
2022220222220220222220222202
2022220222220220222220222202
2022220222220220222220222202
2000000000000000000000000002
2022220220222222220220222202
2022220220222222220220222202
2000000220000220000220000002
2222220222220220222220222222
3333320222220220222220233333
3333320220000000000220233333
3333320220222112220220233333
2222220220211111120220222222
0000000000211111120000000000
2222220220211111120220222222
3333320220222222220220233333
3333320220000000000220233333
2222220220222222220220222222
2222220220222222220220222222
2000000000000220000000000002
2022220222220220222220222202
2022220222220220222220222202
2000220000000000000000220002
2220220220222222220220220222
2220220220222222220220220222
2000000220000220000220000002
2022222222220220222222222202
2022222222220220222222222202
2000000000000000000000000002
2222222222222222222222222222
3333333333333333333333333333
3333333333333333333333333333
3333333333333333333333333333

